Map1
50
20
11111111111111111111111111111111111111111111111111
11111111111110000000000000000000111111111111111111
11111111111110000000000000000000111111111111111111
11111111111110000000000000000000111111111111111111
11111111111110000000000000000000111111111111111111
11111111111110000000000000000000111111111111111111
11111111111110000000000000000000111111111111111111
11111111111110000000000000000000111111111111111111
11111111111110000000000000000000111111111111111111
11100000000000000000000000000000000000000011111111
11100000000000000000000000000000000000000011111111
11100000000000000000000000000000000000000011111111
11100000000000000000000000000000000000000011111111
11100000000000000000000000000000000000000011111111
11111111111110000000000000000000111111111111111111
11111111111110000000000000000000111111111111111111
11111111111110000000000000000000111111111111111111
11111111111110000000000000000000111111111111111111
11111111111110000000000000000000111111111111111111
11111111111111111111111111111111111111111111111111
