Brandon
25
O,|O,|O,|O,|O,|O,|O,|O,|O,|O,|O,|O,|O,|O,|O,|O,|O,|O,|O,|O,|O,|O,|O,|O,|O,|
O,|0,|0,|0,|0,|0,|O,|0,|0,|0,|0,|0,|0,|0,|0,|0,|0,|0,|0,|0,|0,|0,|0,|0,|O,|
O,|0,|0,|0,|0,|0,|O,|0,|0,|0,|0,|0,|0,|0,|0,|0,|0,|0,|0,|0,|0,|0,|0,|0,|O,|
O,|0,|0,|0,|0,|0,|O,|0,|0,|0,|0,|0,|0,|0,|0,|0,|0,|0,|0,|0,|0,|0,|0,|0,|O,|
O,|0,|0,|0,|0,|0,|O,|0,|0,|0,|0,|0,|0,|0,|0,|0,|0,|0,|0,|0,|0,|0,|0,|0,|O,|
O,|0,|0,|0,|0,|0,|O,|0,|0,|0,|0,|0,|0,|0,|0,|0,|0,|0,|0,|0,|0,|0,|0,|0,|O,|
O,|0,|0,|0,|0,|0,|O,|0,|0,|0,|0,|0,|0,|0,|0,|0,|0,|0,|0,|0,|0,|0,|0,|0,|O,|
O,|0,|0,|0,|0,|0,|O,|0,|0,|0,|0,|0,|0,|0,|0,|0,|0,|0,|0,|0,|0,|0,|0,|0,|O,|
O,|0,|0,|0,|0,|0,|O,|0,|0,|0,|0,|0,|0,|0,|0,|0,|0,|0,|0,|0,|0,|0,|0,|0,|O,|
O,|0,|0,|0,|0,|0,|0,|0,|0,|0,|0,|0,|0,|0,|0,|0,|0,|0,|0,|0,|0,|0,|0,|0,|O,|
O,|0,|0,|0,|0,|0,|0,|0,|0,|0,|0,|0,|0,|0,|0,|0,|0,|0,|0,|0,|0,|0,|0,|0,|O,|
O,|0,|0,|0,|0,|0,|0,|0,|0,|0,|0,|0,|0,|0,|0,|0,|0,|0,|0,|0,|0,|0,|0,|0.|O,|
O,|0,|0,|0,|0,|0,|0,|0,|0,|0,|0,|0,|0,|0,|0,|0,|0,|0,|0,|0,|0,|0,|0,|0,|O,|
O,|0,|0,|0,|0,|0,|0,|0,|0,|0,|0,|0,|0,|0,|0,|0,|0,|0,|0,|0,|0,|0,|0,|0,|O,|
O,|0,|0,|0,|0,|0,|0,|0,|0,|0,|0,|0,|0,|0,|0,|0,|0,|0,|0,|0,|0,|0,|0,|0,|O,|
O,|0,|0,|0,|0,|0,|0,|0,|0,|0,|0,|0,|0,|0,|0,|0,|0,|0,|0,|0,|0,|0,|0,|0,|O,|
O,|0,|0,|0,|0,|0,|O,|0,|0,|0,|0,|0,|0,|0,|0,|0,|0,|0,|0,|0,|0,|0,|0,|0,|O,|
O,|0,|0,|0,|0,|0,|O,|0,|0,|0,|0,|0,|0,|0,|0,|0,|0,|0,|DO,|0,|0,|0,|0,|0,|O,|
O,|0,|0,|0,|0,|0,|O,|0,|0,|0,|0,|0,|0,|0,|0,|0,|0,|0,|0,|0,|0,|0,|0,|0,|O,|
O,|0,|0,|0,|0,|0,|O,|0,|0,|0,|0,|0,|0,|0,|0,|0,|0,|0,|0,|0,|0,|0,|0,|0,|O,|
O,|0,|0,|0,|0,|0,|O,|0,|0,|0,|0,|0,|0,|0,|0,|0,|0,|0,|0,|0,|0,|0,|0,|0,|O,|
O,|0,|0,|0,|0,|0,|O,|0,|0,|0,|0,|0,|0,|0,|0,|0,|0,|0,|0,|0,|0,|0,|0,|0,|O,|
O,|0,|0,|0,|0,|0,|O,|0,|0,|0,|0,|0,|0,|0,|0,|0,|0,|0,|0,|0,|0,|0,|0,|0,|O,|
O,|0,|0,|0,|0,|0,|0,|0,|0,|0,|0,|0,|0,|0,|0,|0,|0,|0,|0,|0,|0,|0,|0,|0,|O,|
O,|O,|O,|O,|O,|O,|O,|O,|O,|O,|O,|O,|O,|O,|O,|O,|O,|O,|O,|O,|O,|O,|O,|O,|O,|